INTELLECT - Интеллект
MIGHT - Сила
PERSONALITY - Сила духа
ENDURANCE - Выносливость
SPEED - Скорость
ACCURACY - Меткость
LUCK - Удача

HUMAN - Человек   
ELF - Эльф      
DWARF - Дварф    
GNOME - Гном    
HALF-ORC - Полуорк  

KNIGHT - Рыцарь
PALADIN - Паладин
ARCHER - Лучник
CLERIC - Клерик
SORCERER - Чародей
ROBBER - Вор
Wizard - Колдун

Good - добрый
Neutral - нейтральный
Evil - злой

Race - раса
Alignment - характер

SP - Очки маны
HP - очки здоровья
AC - класс брони
Gems - Драгоценные камни

Condition - состояние

Equipped - Экипировка
Backpack - Мешок

Inn - номера

Города:
Sorpigal - Сорпигал
Portsmith - Портсмит
Algary - Алгари
Dusk - Даск
Erliquin - Эрликин

Имена:
Ranalou - Раналу

Местность:
Korin Bluffs - Утес газели
Brisbane Bay - Залив Брисбен
Blithes Peak - Пик радости
VOLCANIC ISLES - вулканические острова
ENCHANTED FOREST - зачарованый лес

Замки:
Doom - Рок

curse - порча